wCCCCCCCCCCCCCCCCCCCCCCCCCCCCCCCCCCCCw
w....................................w
w....................................w
w....................................w
w..................................RDw
w...............................R.cccw
w.............................ccc....w
w.........................MRR........w
w.........................ccc........w
w...............RM....RR.............w
w..............ccc....ccc............w
w....................................w
w..............RMR..R................w
w..........ppppppppppppppB...........w
w.........BvvvvvvvvvvvvvvTBB.........w
w@........BBvvvvvvvvvvvvvvvvB........w
w####################################w
