wCCCCCCCCCCCCCCCCCCCCCCCCCCCCCCCCCCCCw
w....................................w
w...................R.............R.Dw
w..............R...ccc....R.....pppppw
w..........R..ccc......ccccccc......Tw
w..R......pcp........................w
wppppppp.............................w
w.................R....R.MM..........w
w...R.....R.....cccccccccccccccc.....w
w..ccc..ccc..........................w
w...............R.M.R................w
w....R.RM.....cccccccccc.............w
w...ccccc............................w
w...........R.....M..................w
w..........ccc....ccc................w
w@...................................w
w####################################w
