wCCCCCCCCCCCCCCCCCCCCCCCCCCCCCCCCCCCCw
w....................................w
w........RRRRRRRR.................@.Sw
w....ccccccccccccccccccccccccccccccccw
wcc................................MBw
w...R.MR..........................GBTw
w.ccccccc..RM............R..R.R...cccw
w.........ccc...R..R.....cccccc......w
w...............ccccc................w
w......R.R.R........................Mw
w......ccccccc.....................MBw
w....................BB...........RBBw
w....................BB............BBw
w................ccccccccccccccccccccw
w.......M..ccc......................Bw
w.....ccc...B......................BBw
w####################################w
